Data operacji;Rodzaj;Wartość;Waluta;Saldo całkowite po operacji
"01-03-2021 12:52:03";"Wypłata środków";"-0.0044";"BTC";"0.02197454"
"19-02-2021 02:46:26";"Pobranie prowizji za transakcję";"0.00";"LTC";"2.80389748"
"19-02-2021 02:46:26";"Otrzymanie środków z transakcji na rachunek";"1.64389748";"LTC";"2.80389748"
"19-02-2021 02:46:26";"Pobranie środków z transakcji z rachunku";"-371.52083";"USDT";"0.000001"
"19-02-2021 02:03:22";"Pobranie prowizji za transakcję";"0.00";"LTC";"1.16"
"19-02-2021 02:03:22";"Otrzymanie środków z transakcji na rachunek";"1.16";"LTC";"1.16"
"19-02-2021 02:03:22";"Pobranie środków z transakcji z rachunku";"-262.16";"USDT";"371.520831"
"17-02-2021 20:40:34";"Pobranie prowizji za transakcję";"0.00";"USDT";"633.680831"
"17-02-2021 20:40:34";"Otrzymanie środków z transakcji na rachunek";"185.313821";"USDT";"633.680831"
"17-02-2021 20:40:34";"Pobranie środków z transakcji z rachunku";"-0.10154182";"ETH";"0.30503203"
"17-02-2021 17:53:10";"Pobranie prowizji za transakcję";"0.00";"USDT";"448.36701"
"17-02-2021 17:53:10";"Otrzymanie środków z transakcji na rachunek";"448.36701";"USDT";"448.36701"
"17-02-2021 17:53:10";"Pobranie środków z transakcji z rachunku";"-0.00879151";"BTC";"0.02637454"
"17-02-2021 10:19:36";"Wypłata środków";"-4171.26";"PLN";"0.00"
"13-02-2021 13:23:23";"Pobranie prowizji za transakcję";"-1.76";"PLN";"4171.26"
"13-02-2021 13:23:23";"Otrzymanie środków z transakcji na rachunek";"673.19";"PLN";"4173.02"
"13-02-2021 13:23:23";"Pobranie środków z transakcji z rachunku";"-0.10";"ETH";"0.40657385"
"13-02-2021 12:27:18";"Pobranie prowizji za transakcję";"-2.02";"PLN";"3499.83"
"13-02-2021 12:27:18";"Otrzymanie środków z transakcji na rachunek";"775.00";"PLN";"3501.85"
"13-02-2021 12:27:18";"Pobranie środków z transakcji z rachunku";"-0.00442858";"BTC";"0.03516605"
"13-02-2021 12:27:17";"Pobranie prowizji za transakcję";"-0.26";"PLN";"2726.85"
"13-02-2021 12:27:17";"Otrzymanie środków z transakcji na rachunek";"99.99";"PLN";"2727.11"
"13-02-2021 12:27:17";"Pobranie środków z transakcji z rachunku";"-0.00057142";"BTC";"0.03959463"
"10-02-2021 13:21:11";"Pobranie prowizji za transakcję";"-3.57";"PLN";"2627.12"
"10-02-2021 13:21:11";"Otrzymanie środków z transakcji na rachunek";"1427.55";"PLN";"2630.69"
"10-02-2021 13:21:11";"Pobranie środków z transakcji z rachunku";"-0.21681973";"ETH";"0.50657385"
"10-02-2021 13:20:38";"Pobranie prowizji za transakcję";"-1.25";"PLN";"1203.14"
"10-02-2021 13:20:38";"Otrzymanie środków z transakcji na rachunek";"499.99";"PLN";"1204.39"
"10-02-2021 13:20:38";"Pobranie środków z transakcji z rachunku";"-0.07594098";"ETH";"0.72339358"
"10-02-2021 13:19:20";"Pobranie prowizji za transakcję";"-1.77";"PLN";"704.40"
"10-02-2021 13:19:20";"Otrzymanie środków z transakcji na rachunek";"706.16";"PLN";"706.17"
"10-02-2021 13:19:20";"Pobranie środków z transakcji z rachunku";"-0.10725449";"ETH";"0.79933456"
"03-02-2021 23:21:00";"Pobranie środków z transakcji z rachunku";"-5152.72";"PLN";"0.01"
"03-02-2021 23:21:00";"Pobranie prowizji za transakcję";"-0.00315127";"ETH";"0.90658905"
"03-02-2021 23:21:00";"Otrzymanie środków z transakcji na rachunek";"0.85169231";"ETH";"0.90974032"
"03-02-2021 23:14:48";"Pobranie prowizji za transakcję";"-0.0000225";"ETH";"0.05804801"
"03-02-2021 23:14:48";"Otrzymanie środków z transakcji na rachunek";"0.009";"ETH";"0.05807051"
"03-02-2021 23:14:48";"Pobranie środków z transakcji z rachunku";"-54.17";"PLN";"5152.73"
"03-02-2021 23:14:10";"Pobranie prowizji za transakcję";"-0.00012299";"ETH";"0.04907051"
"03-02-2021 23:14:10";"Otrzymanie środków z transakcji na rachunek";"0.0491935";"ETH";"0.0491935"
"03-02-2021 23:14:10";"Pobranie środków z transakcji z rachunku";"-296.09";"PLN";"5206.90"
"03-02-2021 22:53:00";"Pobranie prowizji za transakcję";"-12.06";"PLN";"5502.99"
"03-02-2021 22:53:00";"Otrzymanie środków z transakcji na rachunek";"4823.02";"PLN";"5515.05"
"03-02-2021 22:53:00";"Pobranie środków z transakcji z rachunku";"-8.4469186";"LTC";"0.00"
"03-02-2021 22:51:05";"Pobranie prowizji za transakcję";"-1.74";"PLN";"692.03"
"03-02-2021 22:51:05";"Otrzymanie środków z transakcji na rachunek";"693.76";"PLN";"693.77"
"03-02-2021 22:51:05";"Pobranie środków z transakcji z rachunku";"-1.21505131";"LTC";"8.4469186"
"03-02-2021 17:29:51";"Pobranie prowizji za transakcję";"-0.02421547";"LTC";"9.66196991"
"03-02-2021 17:29:51";"Otrzymanie środków z transakcji na rachunek";"9.68618538";"LTC";"9.68618538"
"03-02-2021 17:29:51";"Pobranie środków z transakcji z rachunku";"-5433.94";"PLN";"0.01"
"03-02-2021 16:23:00";"Pobranie prowizji za transakcję";"-7.00";"PLN";"5433.95"
"03-02-2021 16:23:00";"Otrzymanie środków z transakcji na rachunek";"2691.56";"PLN";"5440.95"
"03-02-2021 16:23:00";"Pobranie środków z transakcji z rachunku";"-0.01984348";"BTC";"0.04016605"
"03-02-2021 16:22:40";"Pobranie prowizji za transakcję";"-4.22";"PLN";"2749.39"
"03-02-2021 16:22:40";"Otrzymanie środków z transakcji na rachunek";"1620.92";"PLN";"2753.61"
"03-02-2021 16:22:40";"Pobranie środków z transakcji z rachunku";"-0.0119502";"BTC";"0.06000953"
"03-02-2021 16:22:40";"Pobranie prowizji za transakcję";"-2.96";"PLN";"1132.69"
"03-02-2021 16:22:40";"Otrzymanie środków z transakcji na rachunek";"1135.62";"PLN";"1135.65"
"03-02-2021 16:22:40";"Pobranie środków z transakcji z rachunku";"-0.00837238";"BTC";"0.07195973"
"03-02-2021 02:46:17";"Pobranie prowizji za transakcję";"-0.00000012";"BTC";"0.08033211"
"03-02-2021 02:46:17";"Otrzymanie środków z transakcji na rachunek";"0.00004522";"BTC";"0.08033223"
"03-02-2021 02:46:17";"Pobranie środków z transakcji z rachunku";"-5.95";"PLN";"0.03"
"03-02-2021 02:46:17";"Pobranie prowizji za transakcję";"-0.00001288";"BTC";"0.08028701"
"03-02-2021 02:46:17";"Otrzymanie środków z transakcji na rachunek";"0.00495054";"BTC";"0.08029989"
"03-02-2021 02:46:17";"Pobranie środków z transakcji z rachunku";"-651.73";"PLN";"5.98"
"03-02-2021 02:46:16";"Pobranie prowizji za transakcję";"-0.00004254";"BTC";"0.07534935"
"03-02-2021 02:46:16";"Otrzymanie środków z transakcji na rachunek";"0.01635867";"BTC";"0.07539189"
"03-02-2021 02:46:16";"Pobranie środków z transakcji z rachunku";"-2153.61";"PLN";"657.71"
"03-02-2021 02:46:16";"Pobranie prowizji za transakcję";"-0.00004814";"BTC";"0.05903322"
"03-02-2021 02:46:16";"Otrzymanie środków z transakcji na rachunek";"0.01851332";"BTC";"0.05908136"
"03-02-2021 02:46:16";"Pobranie środków z transakcji z rachunku";"-2437.27";"PLN";"2811.32"
"02-02-2021 13:22:08";"Pobranie prowizji za transakcję";"-4.85";"PLN";"5248.59"
"02-02-2021 13:22:08";"Otrzymanie środków z transakcji na rachunek";"1937.17";"PLN";"5253.44"
"02-02-2021 13:22:07";"Pobranie środków z transakcji z rachunku";"-0.3689862";"ETH";"0.00"
"02-02-2021 12:54:08";"Pobranie prowizji za transakcję";"-0.51";"PLN";"3316.27"
"02-02-2021 12:54:08";"Otrzymanie środków z transakcji na rachunek";"203.31";"PLN";"3316.78"
"02-02-2021 12:54:08";"Pobranie środków z transakcji z rachunku";"-0.03872761";"ETH";"0.3689862"
"02-02-2021 12:51:05";"Pobranie prowizji za transakcję";"-1.25";"PLN";"3113.47"
"02-02-2021 12:51:05";"Otrzymanie środków z transakcji na rachunek";"499.99";"PLN";"3114.72"
"02-02-2021 12:51:05";"Pobranie środków z transakcji z rachunku";"-0.09523809";"ETH";"0.40771381"
"02-02-2021 12:50:50";"Pobranie prowizji za transakcję";"-1.47";"PLN";"2614.73"
"02-02-2021 12:50:50";"Otrzymanie środków z transakcji na rachunek";"584.50";"PLN";"2616.20"
"02-02-2021 12:50:50";"Pobranie środków z transakcji z rachunku";"-0.11133475";"ETH";"0.5029519"
"02-02-2021 12:50:47";"Pobranie prowizji za transakcję";"-2.51";"PLN";"2031.70"
"02-02-2021 12:50:47";"Otrzymanie środków z transakcji na rachunek";"1000.98";"PLN";"2034.21"
"02-02-2021 12:50:47";"Pobranie środków z transakcji z rachunku";"-0.19066476";"ETH";"0.61428665"
"02-02-2021 12:50:06";"Pobranie prowizji za transakcję";"-2.59";"PLN";"1033.23"
"02-02-2021 12:50:06";"Otrzymanie środków z transakcji na rachunek";"1035.82";"PLN";"1035.82"
"02-02-2021 12:50:06";"Pobranie środków z transakcji z rachunku";"-0.1973007";"ETH";"0.80495141"
"01-02-2021 10:42:03";"Wypłata środków";"-1994.13";"PLN";"0.00"
"31-01-2021 11:24:09";"Pobranie prowizji za transakcję";"-2.25";"PLN";"1994.13"
"31-01-2021 11:24:09";"Otrzymanie środków z transakcji na rachunek";"899.13";"PLN";"1996.38"
"31-01-2021 11:24:09";"Pobranie środków z transakcji z rachunku";"-0.18";"ETH";"1.00225211"
"30-01-2021 23:02:07";"Pobranie prowizji za transakcję";"-2.75";"PLN";"1097.25"
"30-01-2021 23:02:07";"Otrzymanie środków z transakcji na rachunek";"1100.00";"PLN";"1100.00"
"30-01-2021 23:02:07";"Pobranie środków z transakcji z rachunku";"-0.00859375";"BTC";"0.04056804"
"29-01-2021 10:03:36";"Pobranie prowizji za transakcję";"-0.00146553";"ETH";"1.18225211"
"29-01-2021 10:03:36";"Otrzymanie środków z transakcji na rachunek";"0.58620875";"ETH";"1.18371764"
"29-01-2021 10:03:36";"Pobranie środków z transakcji z rachunku";"-2948.63";"PLN";"0.00"
"29-01-2021 08:47:54";"Pobranie prowizji za transakcję";"-7.40";"PLN";"2948.63"
"29-01-2021 08:47:54";"Otrzymanie środków z transakcji na rachunek";"2956.02";"PLN";"2956.03"
"29-01-2021 08:47:54";"Pobranie środków z transakcji z rachunku";"-221.59145209";"OMG";"0.00"
"23-01-2021 22:21:17";"Pobranie środków z transakcji z rachunku";"-1196.88";"PLN";"0.01"
"23-01-2021 22:21:17";"Pobranie prowizji za transakcję";"-0.31632093";"OMG";"221.59145209"
"23-01-2021 22:21:17";"Otrzymanie środków z transakcji na rachunek";"85.49214285";"OMG";"221.90777302"
"23-01-2021 22:21:17";"Pobranie środków z transakcji z rachunku";"-51.05";"PLN";"1196.89"
"23-01-2021 22:21:17";"Pobranie prowizji za transakcję";"-0.0134944";"OMG";"136.41563017"
"23-01-2021 22:21:17";"Otrzymanie środków z transakcji na rachunek";"3.64713378";"OMG";"136.42912457"
"23-01-2021 22:21:17";"Pobranie środków z transakcji z rachunku";"-209.39";"PLN";"1247.94"
"23-01-2021 22:21:17";"Pobranie prowizji za transakcję";"-0.05533905";"OMG";"132.78199079"
"23-01-2021 22:21:17";"Otrzymanie środków z transakcji na rachunek";"14.9565";"OMG";"132.83732984"
"23-01-2021 22:21:17";"Pobranie środków z transakcji z rachunku";"-107.36";"PLN";"1457.33"
"23-01-2021 22:21:17";"Pobranie prowizji za transakcję";"-0.02837616";"OMG";"117.88082984"
"23-01-2021 22:21:17";"Otrzymanie środków z transakcji na rachunek";"7.66923076";"OMG";"117.909206"
"23-01-2021 22:21:17";"Pobranie środków z transakcji z rachunku";"-21.29";"PLN";"1564.69"
"23-01-2021 22:21:17";"Pobranie prowizji za transakcję";"-0.00562922";"OMG";"110.23997524"
"23-01-2021 22:21:17";"Otrzymanie środków z transakcji na rachunek";"1.52140841";"OMG";"110.24560446"
"23-01-2021 22:21:17";"Pobranie środków z transakcji z rachunku";"-9.76";"PLN";"1585.98"
"23-01-2021 22:21:17";"Pobranie prowizji za transakcję";"-0.00258077";"OMG";"108.72419605"
"23-01-2021 22:21:17";"Otrzymanie środków z transakcji na rachunek";"0.69750336";"OMG";"108.72677682"
"23-01-2021 22:21:17";"Pobranie środków z transakcji z rachunku";"-14.17";"PLN";"1595.74"
"23-01-2021 22:21:17";"Pobranie prowizji za transakcję";"-0.00374709";"OMG";"108.02927346"
"23-01-2021 22:21:17";"Otrzymanie środków z transakcji na rachunek";"1.01272555";"OMG";"108.03302055"
"23-01-2021 22:21:17";"Pobranie środków z transakcji z rachunku";"-1429.76";"PLN";"1609.91"
"23-01-2021 22:21:17";"Pobranie prowizji za transakcję";"-0.37786551";"OMG";"107.020295"
"23-01-2021 22:21:17";"Otrzymanie środków z transakcji na rachunek";"102.12581327";"OMG";"107.39816051"
"23-01-2021 22:21:17";"Pobranie środków z transakcji z rachunku";"-74.03";"PLN";"3039.67"
"23-01-2021 22:21:17";"Pobranie prowizji za transakcję";"-0.01958014";"OMG";"5.27234724"
"23-01-2021 22:21:17";"Otrzymanie środków z transakcji na rachunek";"5.29192738";"OMG";"5.29192738"
"23-01-2021 22:07:45";"Pobranie prowizji za transakcję";"-0.000979";"ETH";"0.59750889"
"23-01-2021 22:07:45";"Otrzymanie środków z transakcji na rachunek";"0.39159758";"ETH";"0.59848789"
"23-01-2021 22:07:45";"Pobranie środków z transakcji z rachunku";"-1828.76";"PLN";"3113.70"
"23-01-2021 22:05:08";"Pobranie prowizji za transakcję";"-0.00051853";"ETH";"0.20689031"
"23-01-2021 22:05:08";"Otrzymanie środków z transakcji na rachunek";"0.20740884";"ETH";"0.20740884"
"23-01-2021 22:05:08";"Pobranie środków z transakcji z rachunku";"-968.59";"PLN";"4942.46"
"23-01-2021 22:01:44";"Pobranie prowizji za transakcję";"-6.51";"PLN";"5911.05"
"23-01-2021 22:01:44";"Otrzymanie środków z transakcji na rachunek";"2600.97";"PLN";"5917.56"
"23-01-2021 22:01:44";"Pobranie środków z transakcji z rachunku";"-0.02163873";"BTC";"0.04916179"
"23-01-2021 22:00:46";"Pobranie prowizji za transakcję";"-0.19";"PLN";"3316.59"
"23-01-2021 22:00:46";"Otrzymanie środków z transakcji na rachunek";"73.28";"PLN";"3316.78"
"23-01-2021 22:00:46";"Pobranie środków z transakcji z rachunku";"-0.00060973";"BTC";"0.07080052"
"23-01-2021 22:00:13";"Pobranie prowizji za transakcję";"-0.25";"PLN";"3243.50"
"23-01-2021 22:00:13";"Otrzymanie środków z transakcji na rachunek";"99.99";"PLN";"3243.75"
"23-01-2021 22:00:13";"Pobranie środków z transakcji z rachunku";"-0.00083194";"BTC";"0.07141025"
"23-01-2021 22:00:02";"Pobranie prowizji za transakcję";"-0.08";"PLN";"3143.76"
"23-01-2021 22:00:02";"Otrzymanie środków z transakcji na rachunek";"30.14";"PLN";"3143.84"
"23-01-2021 22:00:02";"Pobranie środków z transakcji z rachunku";"-0.00025082";"BTC";"0.07224219"
"23-01-2021 21:56:30";"Pobranie prowizji za transakcję";"-4.99";"PLN";"3113.70"
"23-01-2021 21:56:30";"Otrzymanie środków z transakcji na rachunek";"1994.04";"PLN";"3118.69"
"23-01-2021 21:56:30";"Pobranie środków z transakcji z rachunku";"-0.01658943";"BTC";"0.07249301"
"23-01-2021 21:55:54";"Pobranie prowizji za transakcję";"-0.04";"PLN";"1124.65"
"23-01-2021 21:55:54";"Otrzymanie środków z transakcji na rachunek";"12.06";"PLN";"1124.69"
"23-01-2021 21:55:54";"Pobranie środków z transakcji z rachunku";"-0.00010041";"BTC";"0.08908244"
"23-01-2021 21:54:19";"Pobranie prowizji za transakcję";"-2.28";"PLN";"1112.63"
"23-01-2021 21:54:19";"Otrzymanie środków z transakcji na rachunek";"911.04";"PLN";"1114.91"
"23-01-2021 21:54:19";"Pobranie środków z transakcji z rachunku";"-0.00757945";"BTC";"0.08918285"
"23-01-2021 21:52:49";"Pobranie prowizji za transakcję";"-0.23";"PLN";"203.87"
"23-01-2021 21:52:49";"Otrzymanie środków z transakcji na rachunek";"91.76";"PLN";"204.10"
"23-01-2021 21:52:49";"Pobranie środków z transakcji z rachunku";"-0.00076345";"BTC";"0.0967623"
"23-01-2021 21:52:46";"Pobranie prowizji za transakcję";"-0.24";"PLN";"112.34"
"23-01-2021 21:52:46";"Otrzymanie środków z transakcji na rachunek";"95.90";"PLN";"112.58"
"23-01-2021 21:52:46";"Pobranie środków z transakcji z rachunku";"-0.00079784";"BTC";"0.09752575"
"20-01-2021 02:09:57";"Pobranie środków z transakcji z rachunku";"-4503.02";"PLN";"16.68"
"20-01-2021 02:09:57";"Pobranie prowizji za transakcję";"-0.00012238";"BTC";"0.09832359"
"20-01-2021 02:09:57";"Otrzymanie środków z transakcji na rachunek";"0.033074";"BTC";"0.09844597"
"20-01-2021 01:38:46";"Pobranie prowizji za transakcję";"-0.17";"PLN";"4519.70"
"20-01-2021 01:38:46";"Otrzymanie środków z transakcji na rachunek";"67.19";"PLN";"4519.87"
"20-01-2021 01:38:46";"Pobranie środków z transakcji z rachunku";"-4.48590359";"OMG";"0.00"
"20-01-2021 01:38:36";"Pobranie prowizji za transakcję";"-5.30";"PLN";"4452.68"
"20-01-2021 01:38:36";"Otrzymanie środków z transakcji na rachunek";"2116.67";"PLN";"4457.98"
"20-01-2021 01:38:36";"Pobranie środków z transakcji z rachunku";"-141.30";"OMG";"4.48590359"
"18-01-2021 06:03:12";"Pobranie prowizji za transakcję";"-4.09";"PLN";"2341.31"
"18-01-2021 06:03:12";"Otrzymanie środków z transakcji na rachunek";"1633.34";"PLN";"2345.40"
"18-01-2021 06:03:12";"Pobranie środków z transakcji z rachunku";"-101.4498677";"OMG";"145.78590359"
"18-01-2021 06:02:56";"Pobranie prowizji za transakcję";"-1.79";"PLN";"712.06"
"18-01-2021 06:02:56";"Otrzymanie środków z transakcji na rachunek";"713.81";"PLN";"713.85"
"18-01-2021 06:02:56";"Pobranie środków z transakcji z rachunku";"-44.33603589";"OMG";"247.23577129"
"16-01-2021 02:35:32";"Pobranie prowizji za transakcję";"-0.00362746";"OMG";"291.57180718"
"16-01-2021 02:35:32";"Otrzymanie środków z transakcji na rachunek";"1.450983";"OMG";"291.57543464"
"16-01-2021 02:35:32";"Pobranie środków z transakcji z rachunku";"-19.80";"PLN";"0.04"
"16-01-2021 02:35:21";"Pobranie prowizji za transakcję";"-0.00657738";"OMG";"290.12445164"
"16-01-2021 02:35:20";"Otrzymanie środków z transakcji na rachunek";"2.630952";"OMG";"290.13102902"
"16-01-2021 02:35:20";"Pobranie środków z transakcji z rachunku";"-35.91";"PLN";"19.84"
"16-01-2021 02:16:09";"Pobranie prowizji za transakcję";"-0.07945889";"OMG";"287.50007702"
"16-01-2021 02:16:09";"Otrzymanie środków z transakcji na rachunek";"31.78355575";"OMG";"287.57953591"
"16-01-2021 02:16:09";"Pobranie środków z transakcji z rachunku";"-433.84";"PLN";"55.75"
"16-01-2021 02:16:08";"Pobranie prowizji za transakcję";"-0.07945889";"OMG";"255.79598016"
"16-01-2021 02:16:08";"Otrzymanie środków z transakcji na rachunek";"31.78355575";"OMG";"255.87543905"
"16-01-2021 02:16:08";"Pobranie środków z transakcji z rachunku";"-433.84";"PLN";"489.59"
"16-01-2021 02:16:07";"Pobranie prowizji za transakcję";"-0.07945064";"OMG";"224.0918833"
"16-01-2021 02:16:07";"Otrzymanie środków z transakcji na rachunek";"31.78025493";"OMG";"224.17133394"
"16-01-2021 02:16:07";"Pobranie środków z transakcji z rachunku";"-433.80";"PLN";"923.43"
"16-01-2021 02:15:55";"Pobranie prowizji za transakcję";"-0.32013459";"OMG";"192.39107901"
"16-01-2021 02:15:55";"Otrzymanie środków z transakcji na rachunek";"128.05383373";"OMG";"192.7112136"
"16-01-2021 02:15:55";"Pobranie środków z transakcji z rachunku";"-1747.93";"PLN";"1357.23"
"16-01-2021 02:15:48";"Pobranie prowizji za transakcję";"-0.07945889";"OMG";"64.65737987"
"16-01-2021 02:15:48";"Otrzymanie środków z transakcji na rachunek";"31.78355575";"OMG";"64.73683876"
"16-01-2021 02:15:48";"Pobranie środków z transakcji z rachunku";"-433.84";"PLN";"3105.16"
"16-01-2021 02:15:47";"Pobranie prowizji za transakcję";"-0.05785065";"OMG";"32.95328301"
"16-01-2021 02:15:47";"Otrzymanie środków z transakcji na rachunek";"23.14025755";"OMG";"33.01113366"
"16-01-2021 02:15:47";"Pobranie środków z transakcji z rachunku";"-315.86";"PLN";"3539.00"
"16-01-2021 02:12:11";"Pobranie prowizji za transakcję";"-0.02473904";"OMG";"9.87087611"
"16-01-2021 02:12:11";"Otrzymanie środków z transakcji na rachunek";"9.89561515";"OMG";"9.89561515"
"16-01-2021 02:12:11";"Pobranie środków z transakcji z rachunku";"-135.07";"PLN";"3854.86"
"16-01-2021 02:10:20";"Pobranie prowizji za transakcję";"-1.88";"PLN";"3989.93"
"16-01-2021 02:10:20";"Otrzymanie środków z transakcji na rachunek";"748.87";"PLN";"3991.81"
"16-01-2021 02:10:20";"Pobranie środków z transakcji z rachunku";"-0.00532438";"BTC";"0.06537197"
"16-01-2021 02:10:18";"Pobranie prowizji za transakcję";"-0.06";"PLN";"3242.94"
"16-01-2021 02:10:18";"Otrzymanie środków z transakcji na rachunek";"22.07";"PLN";"3243.00"
"16-01-2021 02:10:18";"Pobranie środków z transakcji z rachunku";"-0.00015693";"BTC";"0.07069635"
"16-01-2021 02:09:56";"Pobranie prowizji za transakcję";"-1.09";"PLN";"3220.93"
"16-01-2021 02:09:56";"Otrzymanie środków z transakcji na rachunek";"432.75";"PLN";"3222.02"
"16-01-2021 02:09:56";"Pobranie środków z transakcji z rachunku";"-0.00307679";"BTC";"0.07085328"
"16-01-2021 02:09:55";"Pobranie prowizji za transakcję";"-1.09";"PLN";"2789.27"
"16-01-2021 02:09:55";"Otrzymanie środków z transakcji na rachunek";"432.75";"PLN";"2790.36"
"16-01-2021 02:09:55";"Pobranie środków z transakcji z rachunku";"-0.00307679";"BTC";"0.07393007"
"16-01-2021 02:09:55";"Pobranie prowizji za transakcję";"-0.50";"PLN";"2357.61"
"16-01-2021 02:09:55";"Otrzymanie środków z transakcji na rachunek";"199.80";"PLN";"2358.11"
"16-01-2021 02:09:55";"Pobranie środków z transakcji z rachunku";"-0.00142055";"BTC";"0.07700686"
"16-01-2021 02:09:54";"Pobranie prowizji za transakcję";"-1.09";"PLN";"2158.31"
"16-01-2021 02:09:54";"Otrzymanie środków z transakcji na rachunek";"432.75";"PLN";"2159.40"
"16-01-2021 02:09:54";"Pobranie środków z transakcji z rachunku";"-0.00307679";"BTC";"0.07842741"
"16-01-2021 02:09:53";"Pobranie prowizji za transakcję";"-1.09";"PLN";"1726.65"
"16-01-2021 02:09:53";"Otrzymanie środków z transakcji na rachunek";"432.75";"PLN";"1727.74"
"16-01-2021 02:09:53";"Pobranie środków z transakcji z rachunku";"-0.00307679";"BTC";"0.0815042"
"16-01-2021 02:09:51";"Pobranie prowizji za transakcję";"-1.09";"PLN";"1294.99"
"16-01-2021 02:09:51";"Otrzymanie środków z transakcji na rachunek";"432.75";"PLN";"1296.08"
"16-01-2021 02:09:51";"Pobranie środków z transakcji z rachunku";"-0.00307679";"BTC";"0.08458099"
"16-01-2021 02:09:50";"Pobranie prowizji za transakcję";"-1.09";"PLN";"863.33"
"16-01-2021 02:09:50";"Otrzymanie środków z transakcji na rachunek";"432.75";"PLN";"864.42"
"16-01-2021 02:09:50";"Pobranie środków z transakcji z rachunku";"-0.00307679";"BTC";"0.08765778"
"16-01-2021 02:09:49";"Pobranie prowizji za transakcję";"-1.09";"PLN";"431.67"
"16-01-2021 02:09:49";"Otrzymanie środków z transakcji na rachunek";"432.75";"PLN";"432.76"
"16-01-2021 02:09:49";"Pobranie środków z transakcji z rachunku";"-0.00307679";"BTC";"0.09073457"
"15-01-2021 16:38:07";"Pobranie prowizji za transakcję";"-0.00010722";"BTC";"0.09381136"
"15-01-2021 16:38:07";"Otrzymanie środków z transakcji na rachunek";"0.04123624";"BTC";"0.09391858"
"15-01-2021 16:38:07";"Pobranie środków z transakcji z rachunku";"-5575.13";"PLN";"0.01"
"15-01-2021 14:16:24";"Pobranie prowizji za transakcję";"-0.00001851";"BTC";"0.05268234"
"15-01-2021 14:16:24";"Otrzymanie środków z transakcji na rachunek";"0.00711744";"BTC";"0.05270085"
"15-01-2021 14:16:24";"Pobranie środków z transakcji z rachunku";"-1000.00";"PLN";"5575.14"
"15-01-2021 13:45:34";"Pobranie prowizji za transakcję";"-5.39";"PLN";"6575.14"
"15-01-2021 13:45:34";"Otrzymanie środków z transakcji na rachunek";"2070.74";"PLN";"6580.53"
"15-01-2021 13:45:34";"Pobranie środków z transakcji z rachunku";"-0.45812869";"ETH";"0.00"
"15-01-2021 13:31:46";"Pobranie prowizji za transakcję";"-11.76";"PLN";"4509.79"
"15-01-2021 13:31:46";"Otrzymanie środków z transakcji na rachunek";"4520.00";"PLN";"4521.55"
"15-01-2021 13:31:46";"Pobranie środków z transakcji z rachunku";"-1.00";"ETH";"0.45812869"
"14-01-2021 15:20:47";"Pobranie prowizji za transakcję";"-0.0004224";"ETH";"1.45812869"
"14-01-2021 15:20:47";"Otrzymanie środków z transakcji na rachunek";"0.16245786";"ETH";"1.45855109"
"14-01-2021 15:20:47";"Pobranie środków z transakcji z rachunku";"-731.06";"PLN";"1.55"
"14-01-2021 15:16:42";"Pobranie prowizji za transakcję";"-1.91";"PLN";"732.61"
"14-01-2021 15:16:42";"Otrzymanie środków z transakcji na rachunek";"734.51";"PLN";"734.52"
"14-01-2021 15:16:42";"Pobranie środków z transakcji z rachunku";"-0.005";"BTC";"0.04558341"
"13-01-2021 19:02:55";"Pobranie prowizji za transakcję";"-0.00129749";"ETH";"1.29609323"
"13-01-2021 19:02:55";"Otrzymanie środków z transakcji na rachunek";"0.49903094";"ETH";"1.29739072"
"13-01-2021 19:02:55";"Pobranie środków z transakcji z rachunku";"-2017.08";"PLN";"0.01"
"13-01-2021 18:40:42";"Pobranie prowizji za transakcję";"-0.00013";"ETH";"0.79835978"
"13-01-2021 18:40:42";"Otrzymanie środków z transakcji na rachunek";"0.05";"ETH";"0.79848978"
"13-01-2021 18:40:42";"Pobranie środków z transakcji z rachunku";"-202.10";"PLN";"2017.09"
"13-01-2021 18:39:31";"Pobranie prowizji za transakcję";"-0.00064734";"ETH";"0.74848978"
"13-01-2021 18:39:31";"Otrzymanie środków z transakcji na rachunek";"0.248975";"ETH";"0.74913712"
"13-01-2021 18:39:31";"Pobranie środków z transakcji z rachunku";"-1006.35";"PLN";"2219.19"
"13-01-2021 18:38:13";"Pobranie prowizji za transakcję";"-0.00013621";"ETH";"0.50016212"
"13-01-2021 18:38:13";"Otrzymanie środków z transakcji na rachunek";"0.05238593";"ETH";"0.50029833"
"13-01-2021 18:38:13";"Pobranie środków z transakcji z rachunku";"-212.26";"PLN";"3225.54"
"13-01-2021 18:37:04";"Pobranie prowizji za transakcję";"-0.00116761";"ETH";"0.4479124"
"13-01-2021 18:37:04";"Otrzymanie środków z transakcji na rachunek";"0.44908001";"ETH";"0.44908001"
"13-01-2021 18:37:04";"Pobranie środków z transakcji z rachunku";"-1819.67";"PLN";"3437.80"
"13-01-2021 11:12:01";"Pobranie prowizji za transakcję";"-2.60";"PLN";"5257.47"
"13-01-2021 11:12:01";"Otrzymanie środków z transakcji na rachunek";"961.36";"PLN";"5260.07"
"13-01-2021 11:12:01";"Pobranie środków z transakcji z rachunku";"-0.00740087";"BTC";"0.05058341"
"13-01-2021 11:11:53";"Pobranie prowizji za transakcję";"-2.16";"PLN";"4298.71"
"13-01-2021 11:11:53";"Otrzymanie środków z transakcji na rachunek";"799.99";"PLN";"4300.87"
"13-01-2021 11:11:53";"Pobranie środków z transakcji z rachunku";"-0.00615863";"BTC";"0.05798428"
"13-01-2021 11:11:28";"Pobranie prowizji za transakcję";"-8.10";"PLN";"3500.88"
"13-01-2021 11:11:28";"Otrzymanie środków z transakcji na rachunek";"2999.99";"PLN";"3508.98"
"13-01-2021 11:11:28";"Pobranie środków z transakcji z rachunku";"-0.02309486";"BTC";"0.06414291"
"13-01-2021 11:11:28";"Pobranie prowizji za transakcję";"-1.38";"PLN";"508.99"
"13-01-2021 11:11:28";"Otrzymanie środków z transakcji na rachunek";"510.37";"PLN";"510.37"
"13-01-2021 11:11:28";"Pobranie środków z transakcji z rachunku";"-0.00392905";"BTC";"0.08723777"
"10-01-2021 13:52:49";"Pobranie prowizji za transakcję";"-0.00008796";"BTC";"0.09116682"
"10-01-2021 13:52:49";"Otrzymanie środków z transakcji na rachunek";"0.03257765";"BTC";"0.09125478"
"10-01-2021 13:52:49";"Pobranie środków z transakcji z rachunku";"-4795.43";"PLN";"0.00"
"10-01-2021 13:51:45";"Pobranie prowizji za transakcję";"-3.82";"PLN";"4795.43"
"10-01-2021 13:51:45";"Otrzymanie środków z transakcji na rachunek";"1414.46";"PLN";"4799.25"
"10-01-2021 13:51:45";"Pobranie środków z transakcji z rachunku";"-0.29437344";"ETH";"0.00"
"10-01-2021 13:51:28";"Pobranie prowizji za transakcję";"-3.77";"PLN";"3384.79"
"10-01-2021 13:51:28";"Otrzymanie środków z transakcji na rachunek";"1393.97";"PLN";"3388.56"
"10-01-2021 13:51:28";"Pobranie środków z transakcji z rachunku";"-0.29010879";"ETH";"0.29437344"
"10-01-2021 13:51:11";"Pobranie prowizji za transakcję";"-5.40";"PLN";"1994.59"
"10-01-2021 13:51:11";"Otrzymanie środków z transakcji na rachunek";"1999.99";"PLN";"1999.99"
"10-01-2021 13:51:11";"Pobranie środków z transakcji z rachunku";"-0.41623309";"ETH";"0.58448223"
"10-01-2021 13:42:26";"Pobranie prowizji za transakcję";"-0.00001926";"BTC";"0.05867713"
"10-01-2021 13:42:26";"Otrzymanie środków z transakcji na rachunek";"0.0071328";"BTC";"0.05869639"
"10-01-2021 13:42:26";"Pobranie środków z transakcji z rachunku";"-1052.73";"PLN";"0.00"
"10-01-2021 13:41:56";"Pobranie prowizji za transakcję";"-2.86";"PLN";"1052.73"
"10-01-2021 13:41:56";"Otrzymanie środków z transakcji na rachunek";"1055.58";"PLN";"1055.59"
"10-01-2021 13:41:56";"Pobranie środków z transakcji z rachunku";"-0.219";"ETH";"1.00071532"
"06-01-2021 19:56:47";"Pobranie prowizji za transakcję";"-0.00031347";"ETH";"1.21971532"
"06-01-2021 19:56:47";"Otrzymanie środków z transakcji na rachunek";"0.11609722";"ETH";"1.22002879"
"06-01-2021 19:56:47";"Pobranie środków z transakcji z rachunku";"-501.53";"PLN";"0.01"
"06-01-2021 19:53:05";"Pobranie prowizji za transakcję";"-1.36";"PLN";"501.54"
"06-01-2021 19:53:05";"Otrzymanie środków z transakcji na rachunek";"502.89";"PLN";"502.90"
"06-01-2021 19:53:05";"Pobranie środków z transakcji z rachunku";"-0.00394116";"BTC";"0.05156359"
"06-01-2021 19:42:32";"Pobranie prowizji za transakcję";"-0.0002781";"ETH";"1.10393157"
"06-01-2021 19:42:32";"Otrzymanie środków z transakcji na rachunek";"0.10299691";"ETH";"1.10420967"
"06-01-2021 19:42:32";"Pobranie środków z transakcji z rachunku";"-100.00";"EUR";"0.02"
"06-01-2021 19:42:32";"Pobranie prowizji za transakcję";"-0.00027752";"ETH";"1.00121276"
"06-01-2021 19:42:32";"Otrzymanie środków z transakcji na rachunek";"0.10278309";"ETH";"1.00149028"
"06-01-2021 19:42:32";"Pobranie środków z transakcji z rachunku";"-99.99";"EUR";"100.02"
"05-01-2021 05:10:37";"Pobranie prowizji za transakcję";"-0.00117008";"ETH";"0.89870719"
"05-01-2021 05:10:37";"Otrzymanie środków z transakcji na rachunek";"0.43336216";"ETH";"0.89987727"
"05-01-2021 05:10:37";"Pobranie środków z transakcji z rachunku";"-1603.43";"PLN";"0.01"
"05-01-2021 04:37:31";"Pobranie prowizji za transakcję";"-0.00002439";"BTC";"0.05550475"
"05-01-2021 04:37:31";"Otrzymanie środków z transakcji na rachunek";"0.00903039";"BTC";"0.05552914"
"05-01-2021 04:37:31";"Pobranie środków z transakcji z rachunku";"-1043.01";"PLN";"1603.44"
"04-01-2021 13:47:36";"Wpłata na rachunek";"200.00";"EUR";"200.01"
"04-01-2021 13:18:28";"Pobranie prowizji za transakcję";"-2.47";"PLN";"2646.45"
"04-01-2021 13:18:28";"Otrzymanie środków z transakcji na rachunek";"911.73";"PLN";"2648.92"
"04-01-2021 13:18:28";"Pobranie środków z transakcji z rachunku";"-0.25467463";"ETH";"0.46651511"
"04-01-2021 13:18:21";"Pobranie prowizji za transakcję";"-2.05";"PLN";"1737.19"
"04-01-2021 13:18:21";"Otrzymanie środków z transakcji na rachunek";"758.38";"PLN";"1739.24"
"04-01-2021 13:18:21";"Pobranie środków z transakcji z rachunku";"-0.21184049";"ETH";"0.72118974"
"04-01-2021 11:19:05";"Pobranie prowizji za transakcję";"-0.00002646";"BTC";"0.04649875"
"04-01-2021 11:19:05";"Otrzymanie środków z transakcji na rachunek";"0.00979881";"BTC";"0.04652521"
"04-01-2021 11:19:05";"Pobranie środków z transakcji z rachunku";"-980.86";"PLN";"980.86"
"04-01-2021 00:56:39";"Pobranie prowizji za transakcję";"-0.00004547";"BTC";"0.0367264"
"04-01-2021 00:56:39";"Otrzymanie środków z transakcji na rachunek";"0.01683849";"BTC";"0.03677187"
"04-01-2021 00:56:39";"Pobranie środków z transakcji z rachunku";"-1960.00";"PLN";"1961.72"
"03-01-2021 21:46:27";"Pobranie prowizji za transakcję";"-0.00131547";"ETH";"0.93303023"
"03-01-2021 21:46:27";"Otrzymanie środków z transakcji na rachunek";"0.46980845";"ETH";"0.9343457"
"03-01-2021 21:46:27";"Pobranie środków z transakcji z rachunku";"-1573.90";"PLN";"3921.72"
"03-01-2021 19:27:19";"Pobranie prowizji za transakcję";"-0.00130436";"ETH";"0.46453725"
"03-01-2021 19:27:19";"Otrzymanie środków z transakcji na rachunek";"0.46584161";"ETH";"0.46584161"
"03-01-2021 19:27:19";"Pobranie środków z transakcji z rachunku";"-1500.00";"PLN";"5495.62"
"03-01-2021 17:43:49";"Pobranie prowizji za transakcję";"-0.70";"PLN";"6995.62"
"03-01-2021 17:43:49";"Otrzymanie środków z transakcji na rachunek";"246.82";"PLN";"6996.32"
"03-01-2021 17:43:49";"Pobranie środków z transakcji z rachunku";"-0.07263807";"ETH";"0.00"
"03-01-2021 17:43:44";"Pobranie prowizji za transakcję";"-3.19";"PLN";"6749.50"
"03-01-2021 17:43:44";"Otrzymanie środków z transakcji na rachunek";"1137.65";"PLN";"6752.69"
"03-01-2021 17:43:44";"Pobranie środków z transakcji z rachunku";"-0.33479999";"ETH";"0.07263807"
"03-01-2021 17:43:31";"Pobranie prowizji za transakcję";"-0.28";"PLN";"5615.04"
"03-01-2021 17:43:31";"Otrzymanie środków z transakcji na rachunek";"99.99";"PLN";"5615.32"
"03-01-2021 17:43:31";"Pobranie środków z transakcji z rachunku";"-0.02942907";"ETH";"0.40743806"
"03-01-2021 17:41:13";"Pobranie prowizji za transakcję";"-0.70";"PLN";"5515.33"
"03-01-2021 17:41:13";"Otrzymanie środków z transakcji na rachunek";"247.99";"PLN";"5516.03"
"03-01-2021 17:41:13";"Pobranie środków z transakcji z rachunku";"-0.0729841";"ETH";"0.43686713"
"03-01-2021 17:41:10";"Pobranie prowizji za transakcję";"-8.15";"PLN";"5268.04"
"03-01-2021 17:41:10";"Otrzymanie środków z transakcji na rachunek";"2909.45";"PLN";"5276.19"
"03-01-2021 17:41:10";"Pobranie środków z transakcji z rachunku";"-0.85622536";"ETH";"0.50985123"
"03-01-2021 17:00:10";"Pobranie prowizji za transakcję";"-0.00005598";"BTC";"0.01993338"
"03-01-2021 17:00:10";"Otrzymanie środków z transakcji na rachunek";"0.01998936";"BTC";"0.01998936"
"03-01-2021 17:00:10";"Pobranie środków z transakcji z rachunku";"-2366.74";"PLN";"2366.74"
"03-01-2021 06:31:34";"Pobranie prowizji za transakcję";"-0.00068348";"ETH";"1.36607659"
"03-01-2021 06:31:34";"Otrzymanie środków z transakcji na rachunek";"0.24409659";"ETH";"1.36676007"
"03-01-2021 06:31:34";"Pobranie środków z transakcji z rachunku";"-675.90";"PLN";"4733.48"
"03-01-2021 06:31:29";"Pobranie prowizji za transakcję";"-0.0003232";"ETH";"1.12266348"
"03-01-2021 06:31:29";"Otrzymanie środków z transakcji na rachunek";"0.11542703";"ETH";"1.12298668"
"03-01-2021 06:31:29";"Pobranie środków z transakcji z rachunku";"-319.61";"PLN";"5409.38"
"03-01-2021 06:31:28";"Pobranie prowizji za transakcję";"-0.00170684";"ETH";"1.00755965"
"03-01-2021 06:31:28";"Otrzymanie środków z transakcji na rachunek";"0.60958436";"ETH";"1.00926649"
"03-01-2021 06:31:28";"Pobranie środków z transakcji z rachunku";"-1687.93";"PLN";"5728.99"
"02-01-2021 15:23:22";"Pobranie prowizji za transakcję";"-5.14";"PLN";"7416.92"
"02-01-2021 15:23:22";"Otrzymanie środków z transakcji na rachunek";"1835.62";"PLN";"7422.06"
"02-01-2021 15:23:22";"Pobranie środków z transakcji z rachunku";"-0.01620961";"BTC";"0.00"
"02-01-2021 15:09:23";"Pobranie prowizji za transakcję";"-5.22";"PLN";"5586.44"
"02-01-2021 15:09:23";"Otrzymanie środków z transakcji na rachunek";"1861.67";"PLN";"5591.66"
"02-01-2021 15:09:23";"Pobranie środków z transakcji z rachunku";"-0.01620961";"BTC";"0.01620961"
"02-01-2021 13:18:10";"Pobranie prowizji za transakcję";"-1.67";"PLN";"3729.99"
"02-01-2021 13:18:10";"Otrzymanie środków z transakcji na rachunek";"595.37";"PLN";"3731.66"
"02-01-2021 13:18:10";"Pobranie środków z transakcji z rachunku";"-0.00541448";"BTC";"0.03241922"
"02-01-2021 13:18:08";"Pobranie prowizji za transakcję";"-0.27";"PLN";"3136.29"
"02-01-2021 13:18:08";"Otrzymanie środków z transakcji na rachunek";"92.89";"PLN";"3136.56"
"02-01-2021 13:18:08";"Pobranie środków z transakcji z rachunku";"-0.00084481";"BTC";"0.0378337"
"02-01-2021 13:18:05";"Pobranie prowizji za transakcję";"-1.40";"PLN";"3043.67"
"02-01-2021 13:18:05";"Otrzymanie środków z transakcji na rachunek";"499.99";"PLN";"3045.07"
"02-01-2021 13:18:05";"Pobranie środków z transakcji z rachunku";"-0.00454712";"BTC";"0.03867851"
"02-01-2021 13:13:28";"Pobranie prowizji za transakcję";"-3.51";"PLN";"2545.08"
"02-01-2021 13:13:28";"Otrzymanie środków z transakcji na rachunek";"1252.86";"PLN";"2548.59"
"02-01-2021 13:13:28";"Pobranie środków z transakcji z rachunku";"-0.01139485";"BTC";"0.04322563"
"02-01-2021 13:13:24";"Pobranie prowizji za transakcję";"-0.30";"PLN";"1295.73"
"02-01-2021 13:13:24";"Otrzymanie środków z transakcji na rachunek";"105.02";"PLN";"1296.03"
"02-01-2021 13:13:24";"Pobranie środków z transakcji z rachunku";"-0.00095525";"BTC";"0.05462048"
"02-01-2021 13:13:23";"Pobranie prowizji za transakcję";"-0.14";"PLN";"1191.01"
"02-01-2021 13:13:23";"Otrzymanie środków z transakcji na rachunek";"49.99";"PLN";"1191.15"
"02-01-2021 13:13:23";"Pobranie środków z transakcji z rachunku";"-0.00045475";"BTC";"0.05557573"
"02-01-2021 13:13:21";"Pobranie prowizji za transakcję";"-0.24";"PLN";"1141.16"
"02-01-2021 13:13:21";"Otrzymanie środków z transakcji na rachunek";"83.52";"PLN";"1141.40"
"02-01-2021 13:13:21";"Pobranie środków z transakcji z rachunku";"-0.00075965";"BTC";"0.05603048"
"02-01-2021 13:13:00";"Pobranie prowizji za transakcję";"-0.26";"PLN";"1057.88"
"02-01-2021 13:13:00";"Otrzymanie środków z transakcji na rachunek";"92.80";"PLN";"1058.14"
"02-01-2021 13:13:00";"Pobranie środków z transakcji z rachunku";"-0.00084405";"BTC";"0.05679013"
"02-01-2021 02:00:42";"Pobranie prowizji za transakcję";"-0.00101609";"ETH";"0.39968213"
"02-01-2021 02:00:42";"Otrzymanie środków z transakcji na rachunek";"0.36288625";"ETH";"0.40069822"
"02-01-2021 02:00:42";"Pobranie środków z transakcji z rachunku";"-965.35";"PLN";"965.34"
"02-01-2021 01:51:33";"Pobranie prowizji za transakcję";"-0.00010618";"ETH";"0.03781197"
"02-01-2021 01:51:33";"Otrzymanie środków z transakcji na rachunek";"0.03791815";"ETH";"0.03791815"
"02-01-2021 01:51:33";"Pobranie środków z transakcji z rachunku";"-100.86";"PLN";"1930.69"
